u            .        .
....... ...... ........
                      .
............... ..... .
                    . .
 .................. . .
 .    .     .     . . .
 . .. . ......... . . .
 . e. .  .      . . . .
 .... .. . ...... . . .
    . .  .        . . .
... . . ......... . . .
. .   .           . . .
. . . ........... . . .
. . .             . . .
. . ................. .
.                     .
.......................
