u          .        .
..... ........ ......
         .          .
...... ........ .....
                    .
 .................. .
 .    .           . .
 . .. . ......... . .
 .  . .  .     e. . .
 .... .. . ...... . .
    . .  .        . .
... . . ......... . .
. . . .           . .
. . . ........... . .
. . .             . .
. . ............. . .
.                   .
.....................
