     .              .
.... . ............ .
         .          .
 .................. .
 .    .           . .
 . .. . ......... . .
 .  . . .      e. . .
 .... . . ....... . .
    . . .         . .
... . . ......... . .
.u. . .           . .
. . . ........... . .
. . .             . .
. . ............. . .
.   .               .
.....................